PLAYER_ID,PLAYER_NAME,PLAYER_LAST_TEAM_ID,PLAYER_LAST_TEAM_ABBREVIATION,AGE,GP,G,FGA_FREQUENCY,FGM,FGA,FG_PCT,EFG_PCT,FG2A_FREQUENCY,FG2M,FG2A,FG2_PCT,FG3A_FREQUENCY,FG3M,FG3A,FG3_PCT
1628983,Shai Gilgeous-Alexander,1610612760,OKC,26.0,76,76,1.0,860,1656,0.519,0.569,0.737,697,1221,0.571,0.263,163,435,0.375
1630162,Anthony Edwards,1610612750,MIN,23.0,79,79,1.0,721,1612,0.447,0.547,0.497,401,801,0.501,0.503,320,811,0.395
1630595,Cade Cunningham,1610612765,DET,23.0,70,70,1.0,683,1456,0.469,0.52,0.713,534,1038,0.514,0.287,149,418,0.356
1628369,Jayson Tatum,1610612738,BOS,27.0,72,71,1.0,651,1442,0.451,0.538,0.501,402,723,0.556,0.499,249,719,0.346
1630224,Jalen Green,1610612745,HOU,23.0,82,82,1.0,608,1437,0.423,0.505,0.54,374,776,0.482,0.46,234,661,0.354
1626164,Devin Booker,1610612756,PHX,28.0,75,75,1.0,654,1420,0.461,0.525,0.612,471,869,0.542,0.388,183,551,0.332
1629639,Tyler Herro,1610612748,MIA,25.0,77,77,1.0,651,1378,0.472,0.563,0.513,400,707,0.566,0.487,251,671,0.374
1629027,Trae Young,1610612737,ATL,26.0,76,76,1.0,566,1376,0.411,0.491,0.533,348,734,0.474,0.467,218,642,0.34
203999,Nikola Jokić,1610612743,DEN,30.0,70,70,1.0,786,1363,0.577,0.627,0.758,648,1033,0.627,0.242,138,330,0.418
1628378,Donovan Mitchell,1610612739,CLE,28.0,71,71,1.0,585,1320,0.443,0.531,0.52,352,687,0.512,0.48,233,633,0.368
203507,Giannis Antetokounmpo,1610612749,MIL,30.0,67,67,1.0,793,1319,0.601,0.607,0.952,779,1256,0.62,0.048,14,63,0.222
201942,DeMar DeRozan,1610612758,SAC,35.0,77,77,1.0,624,1308,0.477,0.509,0.804,540,1051,0.514,0.196,84,257,0.327
201935,James Harden,1610612746,LAC,35.0,79,79,1.0,531,1295,0.41,0.501,0.484,296,627,0.472,0.516,235,668,0.352
2544,LeBron James,1610612747,LAL,40.0,70,70,1.0,651,1270,0.513,0.571,0.688,502,874,0.574,0.312,149,396,0.376
201939,Stephen Curry,1610612744,GSW,37.0,70,70,1.0,564,1257,0.449,0.572,0.377,253,474,0.534,0.623,311,783,0.397
203897,Zach LaVine,1610612758,SAC,30.0,74,74,1.0,625,1223,0.511,0.609,0.562,386,687,0.562,0.438,239,536,0.446
1626157,Karl-Anthony Towns,1610612752,NYK,29.0,71,71,1.0,635,1203,0.528,0.586,0.724,494,871,0.567,0.276,141,332,0.425
1628991,Jaren Jackson Jr.,1610612763,MEM,25.0,73,72,1.0,586,1198,0.489,0.55,0.679,441,814,0.542,0.321,145,384,0.378
1627783,Pascal Siakam,1610612754,IND,31.0,78,78,1.0,613,1182,0.519,0.572,0.726,487,858,0.568,0.274,126,324,0.389
1628973,Jalen Brunson,1610612752,NYK,28.0,64,64,1.0,575,1177,0.489,0.552,0.668,425,786,0.541,0.332,150,391,0.384
1629636,Darius Garland,1610612739,CLE,25.0,75,75,1.0,554,1174,0.472,0.562,0.549,342,645,0.53,0.451,212,529,0.401
1628969,Mikal Bridges,1610612752,NYK,28.0,81,80,1.0,585,1169,0.5,0.571,0.608,421,711,0.592,0.392,164,458,0.358
1631114,Jalen Williams,1610612760,OKC,24.0,69,69,1.0,565,1168,0.484,0.537,0.709,441,828,0.533,0.291,124,340,0.365
1628368,De'Aaron Fox,1610612759,SAS,27.0,62,62,1.0,539,1163,0.463,0.514,0.672,421,782,0.538,0.328,118,381,0.31
1630532,Franz Wagner,1610612753,ORL,23.0,60,60,1.0,537,1161,0.463,0.507,0.697,433,809,0.535,0.303,104,352,0.295
1630578,Alperen Sengun,1610612745,HOU,22.0,76,76,1.0,567,1143,0.496,0.505,0.921,546,1053,0.519,0.079,21,90,0.233
1629014,Anfernee Simons,1610612757,POR,25.0,70,70,1.0,479,1125,0.426,0.521,0.473,264,532,0.496,0.527,215,593,0.363
201142,Kevin Durant,1610612756,PHX,36.0,62,62,1.0,592,1124,0.527,0.598,0.669,432,752,0.574,0.331,160,372,0.43
1629632,Coby White,1610612741,CHI,25.0,74,74,1.0,508,1121,0.453,0.55,0.479,292,537,0.544,0.521,216,584,0.37
1628389,Bam Adebayo,1610612748,MIA,27.0,78,78,1.0,540,1113,0.485,0.521,0.801,461,892,0.517,0.199,79,221,0.357
1627750,Jamal Murray,1610612743,DEN,28.0,67,67,1.0,523,1106,0.473,0.543,0.646,368,714,0.515,0.354,155,392,0.395
1627759,Jaylen Brown,1610612738,BOS,28.0,63,62,1.0,512,1105,0.463,0.516,0.677,396,748,0.529,0.323,116,357,0.325
1631101,Shaedon Sharpe,1610612757,POR,22.0,72,72,1.0,499,1104,0.452,0.519,0.572,352,632,0.557,0.428,147,472,0.311
1630178,Tyrese Maxey,1610612755,PHI,24.0,52,52,1.0,477,1091,0.437,0.511,0.562,316,613,0.515,0.438,161,478,0.337
1628970,Miles Bridges,1610612766,CHA,27.0,64,64,1.0,469,1089,0.431,0.495,0.587,328,639,0.513,0.413,141,450,0.313
1627736,Malik Beasley,1610612765,DET,28.0,82,82,1.0,460,1069,0.43,0.579,0.285,142,305,0.466,0.715,318,764,0.416
1630567,Scottie Barnes,1610612761,TOR,23.0,65,65,1.0,473,1062,0.445,0.481,0.736,397,782,0.508,0.264,76,280,0.271
1629673,Jordan Poole,1610612764,WAS,25.0,68,68,1.0,457,1056,0.433,0.544,0.411,222,434,0.512,0.589,235,622,0.378
202696,Nikola Vučević,1610612741,CHI,34.0,73,73,1.0,550,1038,0.53,0.592,0.691,421,717,0.587,0.309,129,321,0.402
1630559,Austin Reaves,1610612747,LAL,27.0,73,73,1.0,477,1037,0.46,0.556,0.488,277,506,0.547,0.512,200,531,0.377
1629008,Michael Porter Jr.,1610612743,DEN,26.0,77,76,1.0,523,1035,0.505,0.598,0.534,332,553,0.6,0.466,191,482,0.396
1629029,Luka Dončić,1610612747,LAL,26.0,50,50,1.0,461,1025,0.45,0.536,0.531,284,544,0.522,0.469,177,481,0.368
1628384,OG Anunoby,1610612752,NYK,27.0,73,73,1.0,482,1010,0.477,0.56,0.554,315,560,0.563,0.446,167,450,0.371
1630169,Tyrese Haliburton,1610612754,IND,25.0,73,73,1.0,476,1006,0.473,0.582,0.441,258,444,0.581,0.559,218,562,0.388
1630163,LaMelo Ball,1610612766,CHA,23.0,47,47,1.0,406,1003,0.405,0.494,0.474,227,475,0.478,0.526,179,528,0.339
1630217,Desmond Bane,1610612763,MEM,26.0,68,68,1.0,484,1001,0.484,0.565,0.586,320,587,0.545,0.414,164,414,0.396
203468,CJ McCollum,1610612740,NOP,33.0,56,56,1.0,444,1000,0.444,0.53,0.541,273,541,0.505,0.459,171,459,0.373
203081,Damian Lillard,1610612749,MIL,34.0,58,58,1.0,444,992,0.448,0.547,0.472,247,468,0.528,0.528,197,524,0.376
1642264,Stephon Castle,1610612759,SAS,20.0,81,81,1.0,423,988,0.428,0.476,0.663,328,655,0.501,0.337,95,333,0.285
1629628,RJ Barrett,1610612761,TOR,24.0,58,58,1.0,459,980,0.468,0.523,0.688,352,674,0.522,0.312,107,306,0.35
1628401,Derrick White,1610612738,BOS,30.0,76,76,1.0,424,959,0.442,0.58,0.279,159,268,0.593,0.721,265,691,0.384
1626181,Norman Powell,1610612746,LAC,32.0,60,60,1.0,457,945,0.484,0.578,0.547,278,517,0.538,0.453,179,428,0.418
202681,Kyrie Irving,1610612742,DAL,33.0,50,50,1.0,447,945,0.473,0.549,0.62,303,586,0.517,0.38,144,359,0.401
1627826,Ivica Zubac,1610612746,LAC,28.0,80,80,1.0,592,940,0.63,0.63,1.0,592,940,0.63,0.0,0,0,
203944,Julius Randle,1610612750,MIN,30.0,69,69,1.0,455,939,0.485,0.542,0.666,347,625,0.555,0.334,108,314,0.344
1628370,Malik Monk,1610612758,SAC,27.0,65,65,1.0,412,939,0.439,0.513,0.544,273,511,0.534,0.456,139,428,0.325
1630700,Dyson Daniels,1610612737,ATL,22.0,76,76,1.0,455,923,0.493,0.536,0.745,375,688,0.545,0.255,80,235,0.34
1629675,Naz Reid,1610612750,MIN,25.0,80,80,1.0,426,923,0.462,0.556,0.499,251,461,0.544,0.501,175,462,0.379
1641718,Keyonte George,1610612762,UTA,21.0,67,67,1.0,359,919,0.391,0.485,0.448,185,412,0.449,0.552,174,507,0.343
1631094,Paolo Banchero,1610612753,ORL,22.0,46,46,1.0,412,911,0.452,0.5,0.701,325,639,0.509,0.299,87,272,0.32
203076,Anthony Davis,1610612742,DAL,32.0,51,51,1.0,470,910,0.516,0.536,0.864,435,786,0.553,0.136,35,124,0.282
1630596,Evan Mobley,1610612739,CLE,23.0,71,71,1.0,505,906,0.557,0.604,0.746,420,676,0.621,0.254,85,230,0.37
1628415,Dillon Brooks,1610612745,HOU,29.0,75,75,1.0,384,895,0.429,0.533,0.476,198,426,0.465,0.524,186,469,0.397
1627734,Domantas Sabonis,1610612758,SAC,29.0,70,69,1.0,527,893,0.59,0.627,0.825,462,737,0.627,0.175,65,156,0.417
1630170,Devin Vassell,1610612759,SAS,24.0,64,64,1.0,394,889,0.443,0.532,0.517,236,460,0.513,0.483,158,429,0.368
202691,Klay Thompson,1610612742,DAL,35.0,72,72,1.0,361,877,0.412,0.535,0.369,145,324,0.448,0.631,216,553,0.391
1629012,Collin Sexton,1610612762,UTA,26.0,63,63,1.0,416,867,0.48,0.543,0.687,306,596,0.513,0.313,110,271,0.406
1629630,Ja Morant,1610612763,MEM,25.0,49,49,1.0,395,867,0.456,0.506,0.678,307,588,0.522,0.322,88,279,0.315
1630202,Payton Pritchard,1610612738,BOS,27.0,80,79,1.0,408,860,0.474,0.622,0.278,154,239,0.644,0.722,254,621,0.409
1641705,Victor Wembanyama,1610612759,SAS,21.0,46,46,1.0,408,857,0.476,0.559,0.53,266,454,0.586,0.47,142,403,0.352
1631097,Bennedict Mathurin,1610612754,IND,22.0,72,72,1.0,391,853,0.458,0.516,0.662,293,565,0.519,0.338,98,288,0.34
1628398,Kyle Kuzma,1610612749,MIL,29.0,65,65,1.0,370,848,0.436,0.493,0.631,274,535,0.512,0.369,96,313,0.307
1630166,Deni Avdija,1610612757,POR,24.0,72,72,1.0,402,844,0.476,0.55,0.595,277,502,0.552,0.405,125,342,0.365
1630530,Trey Murphy III,1610612740,NOP,24.0,53,52,1.0,381,839,0.454,0.548,0.478,223,401,0.556,0.522,158,438,0.361
203952,Andrew Wiggins,1610612748,MIA,30.0,60,60,1.0,376,839,0.448,0.526,0.585,246,491,0.501,0.415,130,348,0.374
1630183,Jaden McDaniels,1610612750,MIN,24.0,82,82,1.0,398,834,0.477,0.537,0.637,298,531,0.561,0.363,100,303,0.33
1642259,Alex Sarr,1610612764,WAS,20.0,67,67,1.0,326,828,0.394,0.457,0.588,221,487,0.454,0.412,105,341,0.308
203471,Dennis Schröder,1610612765,DET,31.0,75,75,1.0,336,826,0.407,0.484,0.551,209,455,0.459,0.449,127,371,0.342
1629656,Quentin Grimes,1610612755,PHI,25.0,75,74,1.0,384,823,0.467,0.565,0.488,222,402,0.552,0.512,162,421,0.385
1631099,Keegan Murray,1610612758,SAC,24.0,76,76,1.0,364,820,0.444,0.538,0.452,210,371,0.566,0.548,154,449,0.343
201566,Russell Westbrook,1610612743,DEN,36.0,75,75,1.0,365,814,0.448,0.504,0.654,275,532,0.517,0.346,90,282,0.319
1631128,Christian Braun,1610612743,DEN,24.0,79,78,1.0,471,811,0.581,0.634,0.729,384,591,0.65,0.271,87,220,0.395
1626167,Myles Turner,1610612754,IND,29.0,72,72,1.0,390,811,0.481,0.577,0.514,234,417,0.561,0.486,156,394,0.396
202699,Tobias Harris,1610612765,DET,32.0,73,73,1.0,384,805,0.477,0.534,0.672,293,541,0.542,0.328,91,264,0.345
1630581,Josh Giddey,1610612741,CHI,22.0,70,70,1.0,366,791,0.463,0.528,0.652,262,516,0.508,0.348,104,275,0.378
1627741,Buddy Hield,1610612744,GSW,32.0,82,82,1.0,328,786,0.417,0.546,0.302,125,237,0.527,0.698,203,549,0.37
1642258,Zaccharie Risacher,1610612737,ATL,20.0,75,75,1.0,357,780,0.458,0.536,0.559,235,436,0.539,0.441,122,344,0.355
1630553,Keon Johnson,1610612751,BKN,23.0,79,79,1.0,303,779,0.389,0.47,0.485,177,378,0.468,0.515,126,401,0.314
201572,Brook Lopez,1610612749,MIL,37.0,80,80,1.0,394,774,0.509,0.599,0.518,255,401,0.636,0.482,139,373,0.373
1629640,Keldon Johnson,1610612759,SAS,25.0,77,77,1.0,371,770,0.482,0.538,0.644,284,496,0.573,0.356,87,274,0.318
1628404,Josh Hart,1610612752,NYK,30.0,76,77,1.0,402,765,0.525,0.58,0.672,319,514,0.621,0.328,83,251,0.331
1629631,De'Andre Hunter,1610612739,CLE,27.0,64,64,1.0,357,759,0.47,0.573,0.49,201,372,0.54,0.51,156,387,0.403
1627832,Fred VanVleet,1610612745,HOU,31.0,60,60,1.0,287,759,0.378,0.483,0.393,128,298,0.43,0.607,159,461,0.345
1642267,Bub Carrington,1610612764,WAS,19.0,82,82,1.0,300,748,0.401,0.493,0.456,162,341,0.475,0.544,138,407,0.339
1629661,Cameron Johnson,1610612751,BKN,29.0,57,57,1.0,355,747,0.475,0.582,0.454,196,339,0.578,0.546,159,408,0.39
1626162,Kelly Oubre Jr.,1610612755,PHI,29.0,60,60,1.0,348,741,0.47,0.518,0.673,277,499,0.555,0.327,71,242,0.293
1630598,Aaron Wiggins,1610612760,OKC,26.0,76,75,1.0,355,728,0.488,0.577,0.534,225,389,0.578,0.466,130,339,0.383
1641739,Toumani Camara,1610612757,POR,25.0,78,78,1.0,328,716,0.458,0.552,0.497,193,356,0.542,0.503,135,360,0.375
1630230,Naji Marshall,1610612742,DAL,27.0,69,69,1.0,362,712,0.508,0.551,0.694,302,494,0.611,0.306,60,218,0.275
1628374,Lauri Markkanen,1610612762,UTA,28.0,47,47,1.0,296,700,0.423,0.521,0.43,158,301,0.525,0.57,138,399,0.346
1641708,Amen Thompson,1610612745,HOU,22.0,69,69,1.0,388,697,0.557,0.575,0.869,363,606,0.599,0.131,25,91,0.275
203078,Bradley Beal,1610612756,PHX,31.0,53,53,1.0,345,694,0.497,0.571,0.62,243,430,0.565,0.38,102,264,0.386
1630703,Scoot Henderson,1610612757,POR,21.0,66,66,1.0,287,685,0.419,0.496,0.566,182,388,0.469,0.434,105,297,0.354
1630168,Onyeka Okongwu,1610612737,ATL,24.0,74,74,1.0,388,684,0.567,0.602,0.784,340,536,0.634,0.216,48,148,0.324
203084,Harrison Barnes,1610612759,SAS,33.0,82,82,1.0,347,683,0.508,0.622,0.473,191,323,0.591,0.527,156,360,0.433
1626145,Tyus Jones,1610612756,PHX,29.0,81,81,1.0,306,683,0.448,0.57,0.413,140,282,0.496,0.587,166,401,0.414
203915,Spencer Dinwiddie,1610612742,DAL,32.0,79,77,1.0,284,682,0.416,0.496,0.522,175,356,0.492,0.478,109,326,0.334
203501,Tim Hardaway Jr.,1610612765,DET,33.0,77,77,1.0,276,680,0.406,0.529,0.328,108,223,0.484,0.672,168,457,0.368
1642377,Jaylen Wells,1610612763,MEM,21.0,78,78,1.0,286,672,0.426,0.528,0.423,149,284,0.525,0.577,137,388,0.353
1629023,P.J. Washington,1610612742,DAL,26.0,57,57,1.0,301,665,0.453,0.521,0.641,210,426,0.493,0.359,91,239,0.381
1630577,Julian Champagnie,1610612759,SAS,23.0,82,82,1.0,276,665,0.415,0.549,0.278,98,185,0.53,0.722,178,480,0.371
1629130,Duncan Robinson,1610612748,MIA,31.0,74,74,1.0,290,663,0.437,0.581,0.271,100,180,0.556,0.729,190,483,0.393
1629018,Gary Trent Jr.,1610612749,MIL,26.0,74,74,1.0,283,657,0.431,0.568,0.341,103,224,0.46,0.659,180,433,0.416
1629645,Kevin Porter Jr.,1610612749,MIL,25.0,75,75,1.0,293,652,0.449,0.492,0.729,238,475,0.501,0.271,55,177,0.311
1641711,Gradey Dick,1610612761,TOR,21.0,54,54,1.0,265,647,0.41,0.498,0.496,151,321,0.47,0.504,114,326,0.35
1628386,Jarrett Allen,1610612739,CLE,27.0,82,82,1.0,452,640,0.706,0.706,0.992,452,635,0.712,0.008,0,5,0.0
1626156,D'Angelo Russell,1610612751,BKN,29.0,58,58,1.0,249,638,0.39,0.479,0.436,136,278,0.489,0.564,113,360,0.314
1630583,Santi Aldama,1610612763,MEM,24.0,64,64,1.0,308,636,0.484,0.577,0.498,190,317,0.599,0.502,118,319,0.37
1626179,Terry Rozier,1610612748,MIA,31.0,64,64,1.0,248,635,0.391,0.462,0.515,157,327,0.48,0.485,91,308,0.295
1641764,Brandin Podziemski,1610612744,GSW,22.0,64,63,1.0,280,629,0.445,0.537,0.509,165,320,0.516,0.491,115,309,0.372
202685,Jonas Valančiūnas,1610612758,SAC,33.0,81,81,1.0,345,627,0.55,0.557,0.941,337,590,0.571,0.059,8,37,0.216
204456,T.J. McConnell,1610612754,IND,33.0,79,78,1.0,324,624,0.519,0.531,0.921,309,575,0.537,0.079,15,49,0.306
1641731,Bilal Coulibaly,1610612764,WAS,20.0,59,59,1.0,263,624,0.421,0.472,0.641,200,400,0.5,0.359,63,224,0.281
202695,Kawhi Leonard,1610612746,LAC,33.0,37,37,1.0,310,623,0.498,0.56,0.695,232,433,0.536,0.305,78,190,0.411
1641710,Anthony Black,1610612753,ORL,21.0,78,77,1.0,262,621,0.422,0.472,0.686,200,426,0.469,0.314,62,195,0.318
1627777,Georges Niang,1610612737,ATL,31.0,79,79,1.0,286,620,0.461,0.595,0.34,120,211,0.569,0.66,166,409,0.406
1630592,Jalen Wilson,1610612751,BKN,24.0,79,79,1.0,246,620,0.397,0.495,0.416,124,258,0.481,0.584,122,362,0.337
1629660,Ty Jerome,1610612739,CLE,27.0,70,70,1.0,319,618,0.516,0.606,0.591,208,365,0.57,0.409,111,253,0.439
1629638,Nickeil Alexander-Walker,1610612750,MIN,26.0,82,82,1.0,270,616,0.438,0.553,0.399,129,246,0.524,0.601,141,370,0.381
1628989,Kevin Huerter,1610612741,CHI,26.0,69,69,1.0,257,604,0.425,0.535,0.353,125,213,0.587,0.647,132,391,0.338
1630167,Obi Toppin,1610612754,IND,27.0,79,78,1.0,317,599,0.529,0.621,0.497,207,298,0.695,0.503,110,301,0.365
1627747,Caris LeVert,1610612737,ATL,30.0,64,64,1.0,280,599,0.467,0.556,0.526,174,315,0.552,0.474,106,284,0.373
1641729,Brice Sensabaugh,1610612762,UTA,21.0,71,70,1.0,275,599,0.459,0.59,0.379,118,227,0.52,0.621,157,372,0.422
202710,Jimmy Butler III,1610612744,GSW,35.0,55,54,1.0,301,597,0.504,0.531,0.826,269,493,0.546,0.174,32,104,0.308
1626171,Bobby Portis,1610612749,MIL,30.0,49,49,1.0,277,595,0.466,0.52,0.701,212,417,0.508,0.299,65,178,0.365
1628978,Donte DiVincenzo,1610612750,MIN,28.0,62,62,1.0,250,594,0.421,0.567,0.263,76,156,0.487,0.737,174,438,0.397
1629652,Luguentz Dort,1610612760,OKC,26.0,71,71,1.0,258,593,0.435,0.578,0.304,88,180,0.489,0.696,170,413,0.412
1630590,Scotty Pippen Jr.,1610612763,MEM,24.0,78,76,1.0,284,591,0.481,0.554,0.631,197,373,0.528,0.369,87,218,0.399
1627884,Derrick Jones Jr.,1610612746,LAC,28.0,77,77,1.0,310,589,0.526,0.593,0.628,232,370,0.627,0.372,78,219,0.356
1631108,Max Christie,1610612742,DAL,22.0,78,78,1.0,252,589,0.428,0.525,0.467,137,275,0.498,0.533,115,314,0.366
1630198,Isaiah Joe,1610612760,OKC,25.0,74,74,1.0,259,588,0.44,0.604,0.207,67,122,0.549,0.793,192,466,0.412
101108,Chris Paul,1610612759,SAS,40.0,82,82,1.0,249,583,0.427,0.547,0.364,109,212,0.514,0.636,140,371,0.377
1627751,Jakob Poeltl,1610612761,TOR,29.0,57,57,1.0,363,579,0.627,0.628,0.995,362,576,0.628,0.005,1,3,0.333
1629060,Rui Hachimura,1610612747,LAL,27.0,59,59,1.0,293,574,0.51,0.599,0.57,191,327,0.584,0.43,102,247,0.413
203924,Jerami Grant,1610612757,POR,31.0,47,47,1.0,214,574,0.373,0.467,0.484,106,278,0.381,0.516,108,296,0.365
202331,Paul George,1610612755,PHI,35.0,41,41,1.0,245,570,0.43,0.514,0.53,149,302,0.493,0.47,96,268,0.358
1626220,Royce O'Neale,1610612756,PHX,31.0,75,75,1.0,241,570,0.423,0.58,0.226,62,129,0.481,0.774,179,441,0.406
1629651,Nic Claxton,1610612751,BKN,26.0,70,70,1.0,320,568,0.563,0.568,0.963,315,547,0.576,0.037,5,21,0.238
1630541,Moses Moody,1610612744,GSW,23.0,74,74,1.0,246,568,0.433,0.544,0.407,120,231,0.519,0.593,126,337,0.374
1641733,Nick Smith Jr.,1610612766,CHA,21.0,60,59,1.0,222,568,0.391,0.482,0.461,118,262,0.45,0.539,104,306,0.34
1630228,Jonathan Kuminga,1610612744,GSW,22.0,47,47,1.0,257,567,0.453,0.494,0.734,211,416,0.507,0.266,46,151,0.305
1631095,Jabari Smith Jr.,1610612745,HOU,22.0,57,57,1.0,248,566,0.438,0.525,0.511,150,289,0.519,0.489,98,277,0.354
1630557,Corey Kispert,1610612764,WAS,26.0,61,61,1.0,255,565,0.451,0.558,0.416,135,235,0.574,0.584,120,330,0.364
1627824,Guerschon Yabusele,1610612755,PHI,29.0,70,70,1.0,282,563,0.501,0.593,0.513,178,289,0.616,0.487,104,274,0.38
201950,Jrue Holiday,1610612738,BOS,34.0,62,62,1.0,250,563,0.444,0.538,0.467,144,263,0.548,0.533,106,300,0.353
1631106,Tari Eason,1610612745,HOU,24.0,57,57,1.0,272,559,0.487,0.543,0.671,209,375,0.557,0.329,63,184,0.342
1642261,Dalton Knecht,1610612747,LAL,24.0,78,76,1.0,257,557,0.461,0.576,0.39,129,217,0.594,0.61,128,340,0.376
204001,Kristaps Porziņģis,1610612738,BOS,29.0,42,41,1.0,268,556,0.482,0.574,0.556,166,309,0.537,0.444,102,247,0.413
1641722,Jordan Hawkins,1610612740,NOP,23.0,56,56,1.0,207,556,0.372,0.471,0.403,97,224,0.433,0.597,110,332,0.331
1641824,Matas Buzelis,1610612741,CHI,20.0,80,78,1.0,252,555,0.454,0.541,0.521,156,289,0.54,0.479,96,266,0.361
1642268,Isaiah Collier,1610612762,UTA,20.0,71,70,1.0,234,555,0.422,0.459,0.695,192,386,0.497,0.305,42,169,0.249
1631105,Jalen Duren,1610612765,DET,21.0,78,77,1.0,378,546,0.692,0.692,1.0,378,546,0.692,0.0,0,0,
1642273,Kyshawn George,1610612764,WAS,21.0,68,67,1.0,203,546,0.372,0.476,0.352,89,192,0.464,0.648,114,354,0.322
203484,Kentavious Caldwell-Pope,1610612753,ORL,32.0,77,76,1.0,239,544,0.439,0.543,0.393,126,214,0.589,0.607,113,330,0.342
1630175,Cole Anthony,1610612753,ORL,25.0,67,66,1.0,230,543,0.424,0.494,0.599,153,325,0.471,0.401,77,218,0.353
1629614,Andrew Nembhard,1610612754,IND,25.0,65,65,1.0,247,539,0.458,0.506,0.675,196,364,0.538,0.325,51,175,0.291
1630552,Jalen Johnson,1610612737,ATL,23.0,36,36,1.0,269,537,0.501,0.542,0.741,225,398,0.565,0.259,44,139,0.317
1630540,Miles McBride,1610612752,NYK,24.0,63,63,1.0,214,535,0.4,0.504,0.428,103,229,0.45,0.572,111,306,0.363
1630534,Ochai Agbaji,1610612761,TOR,25.0,64,64,1.0,266,534,0.498,0.593,0.526,165,281,0.587,0.474,101,253,0.399
1628381,John Collins,1610612762,UTA,27.0,40,40,1.0,280,531,0.527,0.583,0.721,221,383,0.577,0.279,59,148,0.399
1630631,Jose Alvarado,1610612740,NOP,27.0,56,56,1.0,204,521,0.392,0.498,0.407,93,212,0.439,0.593,111,309,0.359
1630533,Ziaire Williams,1610612751,BKN,23.0,63,63,1.0,214,520,0.412,0.511,0.419,111,218,0.509,0.581,103,302,0.341
1642271,Kyle Filipowski,1610612762,UTA,21.0,72,71,1.0,260,518,0.502,0.576,0.575,183,298,0.614,0.425,77,220,0.35
1630172,Patrick Williams,1610612741,CHI,23.0,63,63,1.0,205,516,0.397,0.49,0.473,109,244,0.447,0.527,96,272,0.353
1627752,Taurean Prince,1610612749,MIL,31.0,80,80,1.0,235,514,0.457,0.6,0.348,88,179,0.492,0.652,147,335,0.439
203497,Rudy Gobert,1610612750,MIN,32.0,72,72,1.0,341,510,0.669,0.669,1.0,341,510,0.669,0.0,0,0,
1629599,Amir Coffey,1610612746,LAC,27.0,72,69,1.0,240,510,0.471,0.57,0.516,139,263,0.529,0.484,101,247,0.409
203110,Draymond Green,1610612744,GSW,35.0,68,68,1.0,216,509,0.424,0.503,0.517,136,263,0.517,0.483,80,246,0.325
1629627,Zion Williamson,1610612740,NOP,24.0,30,30,1.0,288,508,0.567,0.57,0.974,285,495,0.576,0.026,3,13,0.231
1630625,Dalano Banton,1610612757,POR,25.0,67,61,1.0,198,507,0.391,0.462,0.562,126,285,0.442,0.438,72,222,0.324
1642347,Jamal Shead,1610612761,TOR,22.0,75,74,1.0,203,503,0.404,0.475,0.557,131,280,0.468,0.443,72,223,0.323
203932,Aaron Gordon,1610612743,DEN,29.0,51,51,1.0,264,497,0.531,0.607,0.654,189,325,0.582,0.346,75,172,0.436
1627749,Dejounte Murray,1610612740,NOP,28.0,31,31,1.0,194,493,0.394,0.446,0.647,142,319,0.445,0.353,52,174,0.299
203992,Bogdan Bogdanović,1610612746,LAC,32.0,54,54,1.0,210,492,0.427,0.534,0.413,105,203,0.517,0.587,105,289,0.363
203903,Jordan Clarkson,1610612762,UTA,32.0,37,37,1.0,201,492,0.409,0.494,0.53,117,261,0.448,0.47,84,231,0.364
1642274,Yves Missi,1610612740,NOP,21.0,73,71,1.0,269,491,0.548,0.548,0.998,269,490,0.549,0.002,0,1,0.0
1628976,Wendell Carter Jr.,1610612753,ORL,26.0,68,68,1.0,226,491,0.46,0.498,0.678,189,333,0.568,0.322,37,158,0.234
1641706,Brandon Miller,1610612766,CHA,22.0,27,27,1.0,198,491,0.403,0.509,0.403,94,198,0.475,0.597,104,293,0.355
1641717,Cason Wallace,1610612760,OKC,21.0,68,68,1.0,232,489,0.474,0.55,0.575,158,281,0.562,0.425,74,208,0.356
1628960,Grayson Allen,1610612756,PHX,29.0,64,64,1.0,219,489,0.448,0.6,0.284,70,139,0.504,0.716,149,350,0.426
1641783,Tristan da Silva,1610612753,ORL,24.0,74,71,1.0,199,483,0.412,0.495,0.505,119,244,0.488,0.495,80,239,0.335
1630591,Jalen Suggs,1610612753,ORL,24.0,35,35,1.0,197,481,0.41,0.489,0.497,121,239,0.506,0.503,76,242,0.314
1628392,Isaiah Hartenstein,1610612760,OKC,27.0,57,57,1.0,278,479,0.58,0.58,0.96,278,460,0.604,0.04,0,19,0.0
1630558,Davion Mitchell,1610612748,MIA,26.0,74,73,1.0,223,476,0.468,0.557,0.557,139,265,0.525,0.443,84,211,0.398
1642346,Ryan Dunn,1610612756,PHX,22.0,74,70,1.0,204,476,0.429,0.514,0.447,123,213,0.577,0.553,81,263,0.308
1630548,Johnny Juzang,1610612762,UTA,24.0,64,64,1.0,204,475,0.429,0.554,0.339,86,161,0.534,0.661,118,314,0.376
1631124,Julian Strawther,1610612743,DEN,23.0,65,64,1.0,202,472,0.428,0.524,0.441,111,208,0.534,0.559,91,264,0.345
1631110,Jeremy Sochan,1610612759,SAS,22.0,54,54,1.0,251,469,0.535,0.565,0.804,223,377,0.592,0.196,28,92,0.304
1630573,Sam Hauser,1610612738,BOS,27.0,71,69,1.0,211,469,0.45,0.624,0.16,48,75,0.64,0.84,163,394,0.414
1629028,Deandre Ayton,1610612757,POR,26.0,40,40,1.0,265,468,0.566,0.573,0.932,259,436,0.594,0.068,6,32,0.188
201144,Mike Conley,1610612750,MIN,37.0,71,71,1.0,187,468,0.4,0.535,0.338,60,158,0.38,0.662,127,310,0.41
1631213,Tyrese Martin,1610612751,BKN,26.0,60,58,1.0,189,465,0.406,0.513,0.394,90,183,0.492,0.606,99,282,0.351
1642276,Kel'el Ware,1610612748,MIA,21.0,64,63,1.0,257,464,0.554,0.592,0.761,222,353,0.629,0.239,35,111,0.315
1631165,Keon Ellis,1610612758,SAC,25.0,80,79,1.0,227,464,0.489,0.639,0.308,88,143,0.615,0.692,139,321,0.433
1641741,Ricky Council IV,1610612755,PHI,23.0,73,69,1.0,177,463,0.382,0.442,0.54,122,250,0.488,0.46,55,213,0.258
1631170,Jaime Jaquez Jr.,1610612748,MIA,24.0,66,62,1.0,213,462,0.461,0.501,0.742,176,343,0.513,0.258,37,119,0.311
1641709,Ausar Thompson,1610612765,DET,22.0,59,58,1.0,246,460,0.535,0.547,0.893,235,411,0.572,0.107,11,49,0.224
201143,Al Horford,1610612738,BOS,39.0,60,59,1.0,192,456,0.421,0.543,0.322,81,147,0.551,0.678,111,309,0.359
1630560,Cam Thomas,1610612751,BKN,23.0,25,25,1.0,199,454,0.438,0.513,0.57,131,259,0.506,0.43,68,195,0.349
1630215,Jared Butler,1610612755,PHI,24.0,60,57,1.0,203,453,0.448,0.514,0.627,143,284,0.504,0.373,60,169,0.355
1630245,Ayo Dosunmu,1610612741,CHI,25.0,46,46,1.0,221,449,0.492,0.561,0.579,159,260,0.612,0.421,62,189,0.328
1631109,Mark Williams,1610612766,CHA,23.0,44,44,1.0,270,447,0.604,0.604,0.991,270,443,0.609,0.009,0,4,0.0
1626166,Cameron Payne,1610612752,NYK,30.0,71,71,1.0,177,439,0.403,0.508,0.426,85,187,0.455,0.574,92,252,0.365
1630193,Immanuel Quickley,1610612761,TOR,25.0,33,33,1.0,184,438,0.42,0.517,0.486,99,213,0.465,0.514,85,225,0.378
1627739,Kris Dunn,1610612746,LAC,31.0,74,74,1.0,192,437,0.439,0.525,0.487,117,213,0.549,0.513,75,224,0.335
1627827,Dorian Finney-Smith,1610612747,LAL,32.0,63,63,1.0,195,435,0.448,0.597,0.278,66,121,0.545,0.722,129,314,0.411
1641744,Zach Edey,1610612763,MEM,23.0,65,65,1.0,247,428,0.577,0.598,0.879,229,376,0.609,0.121,18,52,0.346
1628379,Luke Kennard,1610612763,MEM,28.0,64,62,1.0,203,424,0.479,0.612,0.394,90,167,0.539,0.606,113,257,0.44
1631260,AJ Green,1610612749,MIL,25.0,73,72,1.0,182,424,0.429,0.612,0.144,27,61,0.443,0.856,155,363,0.427
1630241,Sam Merrill,1610612739,CLE,29.0,71,70,1.0,172,424,0.406,0.567,0.132,35,56,0.625,0.868,137,368,0.372
1630182,Josh Green,1610612766,CHA,24.0,68,68,1.0,180,421,0.428,0.543,0.411,83,173,0.48,0.589,97,248,0.391
1631117,Walker Kessler,1610612762,UTA,23.0,58,58,1.0,278,420,0.662,0.669,0.917,272,385,0.706,0.083,6,35,0.171
1631212,Peyton Watson,1610612743,DEN,22.0,68,68,1.0,200,420,0.476,0.531,0.683,154,287,0.537,0.317,46,133,0.346
1629216,Gabe Vincent,1610612747,LAL,28.0,72,69,1.0,168,420,0.4,0.53,0.264,59,111,0.532,0.736,109,309,0.353
1641842,Ronald Holland II,1610612765,DET,19.0,81,81,1.0,197,415,0.475,0.518,0.639,161,265,0.608,0.361,36,150,0.24
1629611,Terance Mann,1610612737,ATL,28.0,67,67,1.0,205,413,0.496,0.569,0.605,145,250,0.58,0.395,60,163,0.368
1631093,Jaden Ivey,1610612765,DET,23.0,30,30,1.0,190,413,0.46,0.536,0.627,127,259,0.49,0.373,63,154,0.409
1630702,Jaden Hardy,1610612742,DAL,22.0,57,54,1.0,180,413,0.436,0.528,0.523,104,216,0.481,0.477,76,197,0.386
1630551,Justin Champagnie,1610612764,WAS,23.0,62,56,1.0,210,411,0.511,0.601,0.53,136,218,0.624,0.47,74,193,0.383
1630188,Jalen Smith,1610612741,CHI,25.0,64,63,1.0,190,408,0.466,0.554,0.456,118,186,0.634,0.544,72,222,0.324
1629655,Daniel Gafford,1610612742,DAL,26.0,57,57,1.0,283,403,0.702,0.702,1.0,283,403,0.702,0.0,0,0,
1641715,Cam Whitmore,1610612745,HOU,20.0,51,47,1.0,179,403,0.444,0.525,0.546,114,220,0.518,0.454,65,183,0.355
1642266,Ja'Kobe Walter,1610612761,TOR,20.0,52,51,1.0,159,393,0.405,0.487,0.527,94,207,0.454,0.473,65,186,0.349
203991,Clint Capela,1610612737,ATL,31.0,55,55,1.0,218,390,0.559,0.559,0.997,218,389,0.56,0.003,0,1,0.0
1629312,Haywood Highsmith,1610612748,MIA,28.0,74,71,1.0,179,390,0.459,0.573,0.405,90,158,0.57,0.595,89,232,0.384
1630174,Aaron Nesmith,1610612754,IND,25.0,45,45,1.0,192,379,0.507,0.617,0.485,108,184,0.587,0.515,84,195,0.431
1630527,Brandon Boston,1610612740,NOP,23.0,42,40,1.0,165,379,0.435,0.5,0.631,116,239,0.485,0.369,49,140,0.35
1631107,Nikola Jović,1610612748,MIA,21.0,46,46,1.0,172,378,0.455,0.558,0.444,94,168,0.56,0.556,78,210,0.371
1642348,Justin Edwards,1610612755,PHI,21.0,44,43,1.0,171,377,0.454,0.544,0.499,103,188,0.548,0.501,68,189,0.36
1629634,Brandon Clarke,1610612763,MEM,28.0,63,64,1.0,232,376,0.617,0.618,0.955,231,359,0.643,0.045,1,17,0.059
1626168,Trey Lyles,1610612758,SAC,29.0,69,68,1.0,157,374,0.42,0.528,0.364,76,136,0.559,0.636,81,238,0.34
1629622,Max Strus,1610612739,CLE,29.0,50,50,1.0,165,373,0.442,0.594,0.214,52,80,0.65,0.786,113,293,0.386
1631323,Simone Fontecchio,1610612765,DET,29.0,75,74,1.0,150,373,0.402,0.504,0.391,74,146,0.507,0.609,76,227,0.335
1641730,Noah Clowney,1610612751,BKN,20.0,46,46,1.0,133,372,0.358,0.474,0.298,46,111,0.414,0.702,87,261,0.333
1628449,Chris Boucher,1610612761,TOR,32.0,50,50,1.0,182,369,0.493,0.588,0.48,112,177,0.633,0.52,70,192,0.365
1641716,Jarace Walker,1610612754,IND,21.0,75,70,1.0,170,360,0.472,0.576,0.486,95,175,0.543,0.514,75,185,0.405
1642367,Jonathan Mogbo,1610612761,TOR,23.0,63,60,1.0,156,356,0.438,0.462,0.803,139,286,0.486,0.197,17,70,0.243
1629026,Kenrich Williams,1610612760,OKC,30.0,69,67,1.0,171,354,0.483,0.576,0.517,105,183,0.574,0.483,66,171,0.386
203994,Jusuf Nurkić,1610612766,CHA,30.0,51,51,1.0,168,352,0.477,0.523,0.702,136,247,0.551,0.298,32,105,0.305
1630570,Trendon Watford,1610612751,BKN,24.0,44,43,1.0,164,350,0.469,0.51,0.749,135,262,0.515,0.251,29,88,0.33
1630208,Nick Richards,1610612756,PHX,27.0,57,56,1.0,205,347,0.591,0.591,0.994,205,345,0.594,0.006,0,2,0.0
1630526,Jeremiah Robinson-Earl,1610612740,NOP,24.0,66,63,1.0,158,347,0.455,0.536,0.527,102,183,0.557,0.473,56,164,0.341
1642419,Jamison Battle,1610612761,TOR,24.0,59,56,1.0,149,347,0.429,0.581,0.254,44,88,0.5,0.746,105,259,0.405
1642275,Tidjane Salaün,1610612766,CHA,19.0,60,60,1.0,114,345,0.33,0.414,0.406,56,140,0.4,0.594,58,205,0.283
203552,Seth Curry,1610612766,CHA,34.0,68,64,1.0,164,343,0.478,0.599,0.469,81,161,0.503,0.531,83,182,0.456
1631096,Chet Holmgren,1610612760,OKC,23.0,32,32,1.0,167,341,0.49,0.554,0.66,123,225,0.547,0.34,44,116,0.379
1629048,Goga Bitadze,1610612753,ORL,25.0,70,62,1.0,207,339,0.611,0.615,0.917,204,311,0.656,0.083,3,28,0.107
1631222,Jake LaRavia,1610612758,SAC,23.0,66,65,1.0,160,337,0.475,0.564,0.579,100,195,0.513,0.421,60,142,0.423
203114,Khris Middleton,1610612764,WAS,33.0,37,37,1.0,160,337,0.475,0.546,0.605,112,204,0.549,0.395,48,133,0.361
1642270,Donovan Clingan,1610612757,POR,21.0,67,67,1.0,180,334,0.539,0.56,0.853,166,285,0.582,0.147,14,49,0.286
1627742,Brandon Ingram,1610612761,TOR,27.0,18,18,1.0,155,333,0.465,0.53,0.655,112,218,0.514,0.345,43,115,0.374
1630173,Precious Achiuwa,1610612752,NYK,25.0,56,56,1.0,163,325,0.502,0.517,0.889,153,289,0.529,0.111,10,36,0.278
1628998,Cody Martin,1610612756,PHX,29.0,53,53,1.0,136,325,0.418,0.485,0.535,93,174,0.534,0.465,43,151,0.285
1628371,Jonathan Isaac,1610612753,ORL,27.0,71,70,1.0,134,324,0.414,0.474,0.534,95,173,0.549,0.466,39,151,0.258
1628418,Thomas Bryant,1610612754,IND,27.0,66,64,1.0,163,321,0.508,0.583,0.539,115,173,0.665,0.461,48,148,0.324
1630549,Day'Ron Sharpe,1610612751,BKN,23.0,50,50,1.0,165,317,0.521,0.538,0.858,154,272,0.566,0.142,11,45,0.244
1630191,Isaiah Stewart,1610612765,DET,24.0,72,69,1.0,176,315,0.559,0.586,0.832,159,262,0.607,0.168,17,53,0.321
203954,Joel Embiid,1610612755,PHI,31.0,19,19,1.0,140,315,0.444,0.481,0.756,117,238,0.492,0.244,23,77,0.299
1627936,Alex Caruso,1610612760,OKC,31.0,54,53,1.0,140,314,0.446,0.541,0.459,80,144,0.556,0.541,60,170,0.353
1628971,Bruce Brown,1610612740,NOP,28.0,41,41,1.0,130,309,0.421,0.464,0.738,103,228,0.452,0.262,27,81,0.333
1630643,Jay Huff,1610612763,MEM,27.0,64,56,1.0,157,305,0.515,0.648,0.344,76,105,0.724,0.656,81,200,0.405
1628997,Caleb Martin,1610612742,DAL,29.0,45,43,1.0,129,304,0.424,0.485,0.661,92,201,0.458,0.339,37,103,0.359
1631218,Trayce Jackson-Davis,1610612744,GSW,25.0,62,54,1.0,174,302,0.576,0.576,0.99,174,299,0.582,0.01,0,3,0.0
1628380,Zach Collins,1610612741,CHI,27.0,64,62,1.0,153,302,0.507,0.56,0.649,121,196,0.617,0.351,32,106,0.302
203937,Kyle Anderson,1610612748,MIA,31.0,61,57,1.0,141,301,0.468,0.51,0.767,116,231,0.502,0.233,25,70,0.357
1629004,Svi Mykhailiuk,1610612762,UTA,27.0,38,37,1.0,118,301,0.392,0.508,0.329,48,99,0.485,0.671,70,202,0.347
1642354,KJ Simpson,1610612766,CHA,22.0,36,36,1.0,104,301,0.346,0.4,0.568,71,171,0.415,0.432,33,130,0.254
1627780,Gary Payton II,1610612744,GSW,32.0,62,61,1.0,171,298,0.574,0.626,0.681,140,203,0.69,0.319,31,95,0.326
1631204,Marcus Sasser,1610612765,DET,24.0,57,52,1.0,136,295,0.461,0.558,0.488,79,144,0.549,0.512,57,151,0.377
1630249,Vít Krejčí,1610612737,ATL,24.0,57,54,1.0,145,292,0.497,0.651,0.295,55,86,0.64,0.705,90,206,0.437
1629659,Talen Horton-Tucker,1610612741,CHI,24.0,58,48,1.0,133,291,0.457,0.527,0.581,92,169,0.544,0.419,41,122,0.336
1629610,DaQuan Jeffries,1610612766,CHA,27.0,47,45,1.0,118,291,0.405,0.5,0.436,63,127,0.496,0.564,55,164,0.335
1629750,Javonte Green,1610612739,CLE,31.0,68,63,1.0,123,288,0.427,0.507,0.51,77,147,0.524,0.49,46,141,0.326
1641763,Julian Phillips,1610612741,CHI,21.0,79,73,1.0,128,287,0.446,0.533,0.467,78,134,0.582,0.533,50,153,0.327
1641767,Ben Sheppard,1610612754,IND,23.0,63,61,1.0,120,287,0.418,0.537,0.307,52,88,0.591,0.693,68,199,0.342
1630572,Sandro Mamukelashvili,1610612759,SAS,26.0,61,56,1.0,141,281,0.502,0.609,0.427,81,120,0.675,0.573,60,161,0.373
1631217,Moussa Diabaté,1610612766,CHA,23.0,71,65,1.0,167,280,0.596,0.596,0.979,167,274,0.609,0.021,0,6,0.0
1628436,Luke Kornet,1610612738,BOS,29.0,73,66,1.0,186,279,0.667,0.667,0.989,186,276,0.674,0.011,0,3,0.0
1631200,Kris Murray,1610612757,POR,24.0,69,59,1.0,117,279,0.419,0.468,0.57,90,159,0.566,0.43,27,120,0.225
1626172,Kevon Looney,1610612744,GSW,29.0,76,71,1.0,141,275,0.513,0.516,0.982,139,270,0.515,0.018,2,5,0.4
1642272,Jared McCain,1610612755,PHI,21.0,23,22,1.0,126,274,0.46,0.553,0.515,75,141,0.532,0.485,51,133,0.383
1642366,Quinten Post,1610612744,GSW,25.0,42,41,1.0,123,274,0.449,0.582,0.347,50,95,0.526,0.653,73,179,0.408
203995,Vasilije Micić,1610612756,PHX,31.0,41,36,1.0,95,273,0.348,0.43,0.542,50,148,0.338,0.458,45,125,0.36
1631157,Ryan Rollins,1610612749,MIL,22.0,56,48,1.0,132,271,0.487,0.577,0.557,83,151,0.55,0.443,49,120,0.408
202692,Alec Burks,1610612748,MIA,33.0,49,48,1.0,115,271,0.424,0.587,0.236,27,64,0.422,0.764,88,207,0.425
1629731,Dean Wade,1610612739,CLE,28.0,59,59,1.0,112,271,0.413,0.561,0.181,32,49,0.653,0.819,80,222,0.36
203482,Kelly Olynyk,1610612740,NOP,34.0,44,43,1.0,134,268,0.5,0.562,0.705,101,189,0.534,0.295,33,79,0.418
1631207,Dalen Terry,1610612741,CHI,22.0,73,66,1.0,120,268,0.448,0.517,0.612,83,164,0.506,0.388,37,104,0.356
1628988,Aaron Holiday,1610612745,HOU,28.0,62,58,1.0,117,268,0.437,0.571,0.325,45,87,0.517,0.675,72,181,0.398
1630171,Isaac Okoro,1610612739,CLE,24.0,55,55,1.0,124,267,0.464,0.569,0.434,68,116,0.586,0.566,56,151,0.371
1641724,Jett Howard,1610612753,ORL,21.0,60,56,1.0,98,262,0.374,0.479,0.29,43,76,0.566,0.71,55,186,0.296
1631115,Orlando Robinson,1610612761,TOR,24.0,44,40,1.0,116,261,0.444,0.477,0.801,99,209,0.474,0.199,17,52,0.327
1629726,Garrison Mathews,1610612737,ATL,28.0,47,45,1.0,102,257,0.397,0.562,0.152,17,39,0.436,0.848,85,218,0.39
203935,Marcus Smart,1610612764,WAS,31.0,34,33,1.0,101,257,0.393,0.488,0.451,52,116,0.448,0.549,49,141,0.348
1642262,Cody Williams,1610612762,UTA,20.0,50,48,1.0,83,257,0.323,0.391,0.475,48,122,0.393,0.525,35,135,0.259
1629003,Shake Milton,1610612747,LAL,28.0,57,46,1.0,115,254,0.453,0.528,0.583,77,148,0.52,0.417,38,106,0.358
1629021,Moritz Wagner,1610612753,ORL,28.0,30,29,1.0,140,249,0.562,0.616,0.699,113,174,0.649,0.301,27,75,0.36
1641810,Antonio Reeves,1610612740,NOP,22.0,44,41,1.0,113,248,0.456,0.558,0.48,62,119,0.521,0.52,51,129,0.395
1630322,Lindy Waters III,1610612765,DET,27.0,52,51,1.0,92,247,0.372,0.502,0.255,28,63,0.444,0.745,64,184,0.348
1628366,Lonzo Ball,1610612741,CHI,27.0,35,35,1.0,89,243,0.366,0.504,0.198,22,48,0.458,0.802,67,195,0.344
1641774,Tristan Vukcevic,1610612764,WAS,22.0,35,33,1.0,120,242,0.496,0.574,0.579,82,140,0.586,0.421,38,102,0.373
1627763,Malcolm Brogdon,1610612764,WAS,32.0,24,24,1.0,104,240,0.433,0.467,0.767,88,184,0.478,0.233,16,56,0.286
1642263,Reed Sheppard,1610612745,HOU,20.0,52,46,1.0,84,239,0.351,0.452,0.406,36,97,0.371,0.594,48,142,0.338
1630200,Tre Jones,1610612741,CHI,25.0,46,46,1.0,128,238,0.538,0.578,0.798,109,190,0.574,0.202,19,48,0.396
201587,Nicolas Batum,1610612746,LAC,36.0,78,70,1.0,104,238,0.437,0.622,0.147,16,35,0.457,0.853,88,203,0.433
1631255,Karlo Matković,1610612740,NOP,24.0,42,38,1.0,135,235,0.574,0.619,0.719,114,169,0.675,0.281,21,66,0.318
203083,Andre Drummond,1610612755,PHI,31.0,40,40,1.0,117,234,0.5,0.506,0.915,114,214,0.533,0.085,3,20,0.15
1630288,Jeff Dowtin Jr.,1610612755,PHI,28.0,41,37,1.0,112,230,0.487,0.548,0.696,84,160,0.525,0.304,28,70,0.4
1631133,Jabari Walker,1610612757,POR,22.0,60,51,1.0,118,229,0.515,0.576,0.686,90,157,0.573,0.314,28,72,0.389
1629013,Landry Shamet,1610612752,NYK,28.0,49,47,1.0,104,228,0.456,0.59,0.32,43,73,0.589,0.68,61,155,0.394
1629637,Jaxson Hayes,1610612747,LAL,25.0,56,54,1.0,161,223,0.722,0.722,0.987,161,220,0.732,0.013,0,3,0.0
1627732,Ben Simmons,1610612746,LAC,28.0,51,48,1.0,116,223,0.52,0.52,1.0,116,223,0.52,0.0,0,0,
1631119,Jaylin Williams,1610612760,OKC,22.0,47,47,1.0,97,221,0.439,0.577,0.308,36,68,0.529,0.692,61,153,0.399
1641787,Tosan Evbuomwan,1610612751,BKN,24.0,28,28,1.0,94,220,0.427,0.482,0.65,70,143,0.49,0.35,24,77,0.312
1642358,AJ Johnson,1610612764,WAS,20.0,29,28,1.0,82,213,0.385,0.441,0.577,58,123,0.472,0.423,24,90,0.267
1629006,Josh Okogie,1610612766,CHA,26.0,40,39,1.0,94,212,0.443,0.519,0.566,62,120,0.517,0.434,32,92,0.348
1629022,Lonnie Walker IV,1610612755,PHI,26.0,20,19,1.0,89,212,0.42,0.526,0.401,44,85,0.518,0.599,45,127,0.354
1642265,Rob Dillingham,1610612750,MIN,20.0,49,41,1.0,93,211,0.441,0.5,0.649,68,137,0.496,0.351,25,74,0.338
201569,Eric Gordon,1610612755,PHI,36.0,39,38,1.0,87,204,0.426,0.564,0.328,31,67,0.463,0.672,56,137,0.409
1641796,Pelle Larsson,1610612748,MIA,24.0,55,46,1.0,89,203,0.438,0.517,0.532,57,108,0.528,0.468,32,95,0.337
203486,Mason Plumlee,1610612756,PHX,35.0,74,64,1.0,125,202,0.619,0.619,0.98,125,198,0.631,0.02,0,4,0.0
1630231,KJ Martin,1610612762,UTA,24.0,43,41,1.0,111,201,0.552,0.59,0.711,96,143,0.671,0.289,15,58,0.259
1641713,GG Jackson,1610612763,MEM,20.0,29,28,1.0,74,199,0.372,0.452,0.523,42,104,0.404,0.477,32,95,0.337
1629674,Neemias Queta,1610612738,BOS,25.0,62,50,1.0,128,198,0.646,0.646,0.985,128,195,0.656,0.015,0,3,0.0
1641748,Andre Jackson Jr.,1610612749,MIL,23.0,67,57,1.0,94,197,0.477,0.553,0.614,64,121,0.529,0.386,30,76,0.395
1628420,Monté Morris,1610612756,PHX,29.0,45,44,1.0,83,195,0.426,0.505,0.559,52,109,0.477,0.441,31,86,0.36
1629234,Drew Eubanks,1610612746,LAC,28.0,61,50,1.0,115,194,0.593,0.601,0.969,112,188,0.596,0.031,3,6,0.5
1641737,Adem Bona,1610612755,PHI,22.0,58,46,1.0,135,192,0.703,0.703,0.995,135,191,0.707,0.005,0,1,0.0
1641726,Dereck Lively II,1610612742,DAL,21.0,36,36,1.0,134,191,0.702,0.702,1.0,134,191,0.702,0.0,0,0,
1631103,Malaki Branham,1610612759,SAS,22.0,47,39,1.0,87,190,0.458,0.547,0.558,53,106,0.5,0.442,34,84,0.405
1631216,Caleb Houstan,1610612753,ORL,22.0,58,50,1.0,80,190,0.421,0.589,0.158,16,30,0.533,0.842,64,160,0.4
1630639,A.J. Lawson,1610612761,TOR,24.0,26,25,1.0,80,190,0.421,0.508,0.468,47,89,0.528,0.532,33,101,0.327
1630314,Brandon Williams,1610612742,DAL,25.0,33,29,1.0,98,188,0.521,0.585,0.681,74,128,0.578,0.319,24,60,0.4
1642345,Oso Ighodaro,1610612756,PHX,22.0,61,52,1.0,113,187,0.604,0.604,0.989,113,185,0.611,0.011,0,2,0.0
1631104,Blake Wesley,1610612759,SAS,22.0,58,51,1.0,81,186,0.435,0.481,0.688,64,128,0.5,0.312,17,58,0.293
1642349,Ajay Mitchell,1610612760,OKC,22.0,36,34,1.0,92,185,0.497,0.559,0.676,69,125,0.552,0.324,23,60,0.383
1629626,Bol Bol,1610612756,PHX,25.0,36,32,1.0,96,183,0.525,0.612,0.492,64,90,0.711,0.508,32,93,0.344
1629618,Jalen Pickett,1610612743,DEN,25.0,49,43,1.0,77,180,0.428,0.539,0.439,37,79,0.468,0.561,40,101,0.396
1630611,Gui Santos,1610612744,GSW,22.0,56,48,1.0,82,179,0.458,0.553,0.425,48,76,0.632,0.575,34,103,0.33
1626192,Pat Connaughton,1610612749,MIL,32.0,41,37,1.0,83,177,0.469,0.542,0.542,57,96,0.594,0.458,26,81,0.321
1641765,Olivier-Maxence Prosper,1610612742,DAL,22.0,52,43,1.0,70,174,0.402,0.437,0.707,58,123,0.472,0.293,12,51,0.235
1630529,Herbert Jones,1610612740,NOP,26.0,20,20,1.0,75,172,0.436,0.5,0.581,53,100,0.53,0.419,22,72,0.306
1631243,Mouhamed Gueye,1610612737,ATL,22.0,33,33,1.0,72,171,0.421,0.482,0.526,51,90,0.567,0.474,21,81,0.259
203500,Steven Adams,1610612745,HOU,31.0,58,49,1.0,91,167,0.545,0.545,0.988,91,165,0.552,0.012,0,2,0.0
1641871,Duop Reath,1610612757,POR,28.0,46,40,1.0,70,166,0.422,0.524,0.361,36,60,0.6,0.639,34,106,0.321
1630811,Keaton Wallace,1610612737,ATL,26.0,31,28,1.0,65,162,0.401,0.485,0.494,38,80,0.475,0.506,27,82,0.329
1630544,Tre Mann,1610612766,CHA,24.0,13,13,1.0,70,161,0.435,0.509,0.627,46,101,0.455,0.373,24,60,0.4
1631246,Vince Williams Jr.,1610612763,MEM,24.0,26,26,1.0,64,161,0.398,0.475,0.422,39,68,0.574,0.578,25,93,0.269
1631221,Collin Gillespie,1610612756,PHX,25.0,33,30,1.0,68,158,0.43,0.554,0.43,29,68,0.426,0.57,39,90,0.433
1631288,Jamal Cain,1610612740,NOP,26.0,37,32,1.0,68,158,0.43,0.513,0.494,42,78,0.538,0.506,26,80,0.325
1626204,Larry Nance Jr.,1610612737,ATL,32.0,24,24,1.0,80,155,0.516,0.626,0.51,46,79,0.582,0.49,34,76,0.447
202709,Cory Joseph,1610612753,ORL,33.0,50,44,1.0,62,154,0.403,0.529,0.305,23,47,0.489,0.695,39,107,0.364
1629111,Jock Landale,1610612745,HOU,29.0,42,35,1.0,81,152,0.533,0.569,0.829,70,126,0.556,0.171,11,26,0.423
1642281,Jaylon Tyson,1610612739,CLE,22.0,47,38,1.0,64,149,0.43,0.497,0.611,44,91,0.484,0.389,20,58,0.345
1630256,Jae'Sean Tate,1610612745,HOU,29.0,52,43,1.0,70,148,0.473,0.527,0.689,54,102,0.529,0.311,16,46,0.348
1630243,Trevelin Queen,1610612753,ORL,28.0,31,25,1.0,56,147,0.381,0.456,0.476,34,70,0.486,0.524,22,77,0.286
1628975,Jevon Carter,1610612741,CHI,29.0,36,32,1.0,55,146,0.377,0.497,0.281,20,41,0.488,0.719,35,105,0.333
1630692,Jordan Goodwin,1610612747,LAL,26.0,29,28,1.0,63,144,0.438,0.528,0.528,37,76,0.487,0.472,26,68,0.382
1630194,Paul Reed,1610612765,DET,25.0,45,38,1.0,72,142,0.507,0.535,0.803,64,114,0.561,0.197,8,28,0.286
1641712,Rayan Rupert,1610612757,POR,21.0,52,38,1.0,58,142,0.408,0.465,0.585,42,83,0.506,0.415,16,59,0.271
1641854,Craig Porter Jr.,1610612739,CLE,25.0,51,35,1.0,72,140,0.514,0.589,0.657,51,92,0.554,0.343,21,48,0.438
201599,DeAndre Jordan,1610612743,DEN,36.0,56,51,1.0,91,139,0.655,0.655,1.0,91,139,0.655,0.0,0,0,
1626158,Richaun Holmes,1610612764,WAS,31.0,31,31,1.0,90,139,0.647,0.647,0.978,90,136,0.662,0.022,0,3,0.0
1630192,Zeke Nnaji,1610612743,DEN,24.0,57,45,1.0,70,139,0.504,0.565,0.626,53,87,0.609,0.374,17,52,0.327
1630556,Kessler Edwards,1610612742,DAL,24.0,40,30,1.0,67,135,0.496,0.578,0.6,45,81,0.556,0.4,22,54,0.407
1630695,Micah Potter,1610612762,UTA,27.0,38,36,1.0,57,135,0.422,0.537,0.274,26,37,0.703,0.726,31,98,0.316
203957,Danté Exum,1610612742,DAL,29.0,20,20,1.0,64,134,0.478,0.563,0.604,41,81,0.506,0.396,23,53,0.434
1641757,Jordan Miller,1610612746,LAC,25.0,37,29,1.0,58,134,0.433,0.463,0.716,50,96,0.521,0.284,8,38,0.211
202704,Reggie Jackson,1610612755,PHI,35.0,31,30,1.0,52,133,0.391,0.485,0.444,27,59,0.458,0.556,25,74,0.338
1641794,Dillon Jones,1610612760,OKC,23.0,54,40,1.0,51,133,0.383,0.444,0.526,35,70,0.5,0.474,16,63,0.254
203914,Gary Harris,1610612753,ORL,30.0,48,41,1.0,51,133,0.383,0.519,0.241,15,32,0.469,0.759,36,101,0.356
1626153,Delon Wright,1610612752,NYK,33.0,40,34,1.0,45,131,0.344,0.42,0.443,25,58,0.431,0.557,20,73,0.274
1641878,Damion Baugh,1610612766,CHA,24.0,15,15,1.0,42,130,0.323,0.369,0.569,30,74,0.405,0.431,12,56,0.214
1628464,Daniel Theis,1610612740,NOP,33.0,38,36,1.0,61,129,0.473,0.508,0.713,52,92,0.565,0.287,9,37,0.243
1641732,Colby Jones,1610612764,WAS,23.0,39,28,1.0,59,129,0.457,0.519,0.62,43,80,0.538,0.38,16,49,0.327
1642269,Devin Carter,1610612758,SAC,23.0,36,32,1.0,47,127,0.37,0.441,0.52,29,66,0.439,0.48,18,61,0.295
1631111,Wendell Moore Jr.,1610612766,CHA,23.0,36,31,1.0,59,126,0.468,0.524,0.675,45,85,0.529,0.325,14,41,0.341
1631223,David Roddy,1610612745,HOU,24.0,33,31,1.0,57,125,0.456,0.532,0.512,38,64,0.594,0.488,19,61,0.311
1631172,Ousmane Dieng,1610612760,OKC,22.0,37,33,1.0,54,125,0.432,0.524,0.432,31,54,0.574,0.568,23,71,0.324
1629684,Grant Williams,1610612766,CHA,26.0,16,16,1.0,54,123,0.439,0.549,0.398,27,49,0.551,0.602,27,74,0.365
1631245,Quenton Jackson,1610612754,IND,26.0,28,22,1.0,58,122,0.475,0.537,0.672,43,82,0.524,0.328,15,40,0.375
203901,Elfrid Payton,1610612740,NOP,31.0,24,24,1.0,40,122,0.328,0.332,0.951,39,116,0.336,0.049,1,6,0.167
201145,Jeff Green,1610612745,HOU,38.0,32,28,1.0,61,121,0.504,0.624,0.347,32,42,0.762,0.653,29,79,0.367
1629020,Jarred Vanderbilt,1610612747,LAL,26.0,36,35,1.0,59,121,0.488,0.525,0.736,50,89,0.562,0.264,9,32,0.281
1641740,Jaylen Clark,1610612750,MIN,23.0,40,35,1.0,56,120,0.467,0.558,0.575,34,69,0.493,0.425,22,51,0.431
1641816,Hunter Tyson,1610612743,DEN,24.0,51,40,1.0,45,120,0.375,0.471,0.383,22,46,0.478,0.617,23,74,0.311
1630538,Bones Hyland,1610612750,MIN,24.0,24,22,1.0,47,118,0.398,0.534,0.305,15,36,0.417,0.695,32,82,0.39
1629646,Charles Bassey,1610612759,SAS,24.0,36,30,1.0,68,117,0.581,0.581,1.0,68,117,0.581,0.0,0,0,
203926,Doug McDermott,1610612758,SAC,33.0,42,31,1.0,50,117,0.427,0.615,0.137,6,16,0.375,0.863,44,101,0.436
200768,Kyle Lowry,1610612755,PHI,39.0,35,32,1.0,41,117,0.35,0.474,0.248,12,29,0.414,0.752,29,88,0.33
201567,Kevin Love,1610612748,MIA,36.0,23,19,1.0,41,115,0.357,0.461,0.417,17,48,0.354,0.583,24,67,0.358
202687,Bismack Biyombo,1610612759,SAS,32.0,28,26,1.0,67,114,0.588,0.588,1.0,67,114,0.588,0.0,0,0,
1630545,Terrence Shannon Jr.,1610612750,MIN,24.0,32,26,1.0,55,114,0.482,0.531,0.728,44,83,0.53,0.272,11,31,0.355
1631230,Dominick Barlow,1610612737,ATL,22.0,35,30,1.0,60,113,0.531,0.562,0.761,53,86,0.616,0.239,7,27,0.259
1628964,Mo Bamba,1610612740,NOP,27.0,32,31,1.0,52,112,0.464,0.531,0.518,37,58,0.638,0.482,15,54,0.278
1631248,Baylor Scheierman,1610612738,BOS,24.0,31,26,1.0,39,110,0.355,0.473,0.255,13,28,0.464,0.745,26,82,0.317
1630539,Kai Jones,1610612742,DAL,24.0,40,28,1.0,87,109,0.798,0.803,0.954,86,104,0.827,0.046,1,5,0.2
1631232,Keion Brooks Jr.,1610612740,NOP,24.0,14,13,1.0,53,109,0.486,0.55,0.606,39,66,0.591,0.394,14,43,0.326
1641721,Maxwell Lewis,1610612751,BKN,22.0,28,21,1.0,45,108,0.417,0.505,0.537,26,58,0.448,0.463,19,50,0.38
1641736,Reece Beekman,1610612751,BKN,23.0,36,29,1.0,35,107,0.327,0.36,0.626,28,67,0.418,0.374,7,40,0.175
1628963,Marvin Bagley III,1610612763,MEM,26.0,31,25,1.0,55,106,0.519,0.533,0.821,52,87,0.598,0.179,3,19,0.158
1630568,Luka Garza,1610612750,MIN,26.0,39,32,1.0,52,105,0.495,0.543,0.657,42,69,0.609,0.343,10,36,0.278
1631209,Isaiah Wong,1610612766,CHA,24.0,20,20,1.0,41,105,0.39,0.452,0.686,28,72,0.389,0.314,13,33,0.394
1631166,Drew Timme,1610612751,BKN,24.0,9,9,1.0,45,102,0.441,0.485,0.657,36,67,0.537,0.343,9,35,0.257
1630311,Pat Spencer,1610612744,GSW,28.0,39,30,1.0,41,101,0.406,0.431,0.782,36,79,0.456,0.218,5,22,0.227
1630658,Colin Castleton,1610612761,TOR,25.0,26,20,1.0,46,98,0.469,0.48,0.837,44,82,0.537,0.163,2,16,0.125
1641720,Jalen Hood-Schifino,1610612755,PHI,21.0,15,14,1.0,37,98,0.378,0.449,0.531,23,52,0.442,0.469,14,46,0.304
1642382,Branden Carlson,1610612760,OKC,25.0,32,26,1.0,43,97,0.443,0.557,0.32,21,31,0.677,0.68,22,66,0.333
1641727,Dariq Whitehead,1610612751,BKN,20.0,20,15,1.0,39,96,0.406,0.578,0.229,6,22,0.273,0.771,33,74,0.446
1628467,Maxi Kleber,1610612747,LAL,33.0,34,29,1.0,37,96,0.385,0.453,0.49,24,47,0.511,0.51,13,49,0.265
201988,Patty Mills,1610612746,LAC,36.0,29,23,1.0,36,96,0.375,0.51,0.219,10,21,0.476,0.781,26,75,0.347
1641745,Adam Flagler,1610612760,OKC,25.0,37,27,1.0,25,96,0.26,0.333,0.25,11,24,0.458,0.75,14,72,0.194
201959,Taj Gibson,1610612766,CHA,39.0,37,32,1.0,47,95,0.495,0.5,0.979,46,93,0.495,0.021,1,2,0.5
1629629,Cam Reddish,1610612747,LAL,25.0,33,30,1.0,38,94,0.404,0.473,0.5,25,47,0.532,0.5,13,47,0.277
1642277,Johnny Furphy,1610612754,IND,20.0,50,26,1.0,35,92,0.38,0.462,0.457,20,42,0.476,0.543,15,50,0.3
1629723,John Konchar,1610612763,MEM,29.0,46,33,1.0,41,91,0.451,0.577,0.319,18,29,0.621,0.681,23,62,0.371
1631169,Josh Minott,1610612750,MIN,22.0,46,35,1.0,44,90,0.489,0.567,0.522,30,47,0.638,0.478,14,43,0.326
1628470,Torrey Craig,1610612738,BOS,34.0,26,21,1.0,38,90,0.422,0.556,0.267,14,24,0.583,0.733,24,66,0.364
1630531,Jaden Springer,1610612762,UTA,22.0,43,28,1.0,35,90,0.389,0.456,0.467,23,42,0.548,0.533,12,48,0.25
1630264,Anthony Gill,1610612764,WAS,32.0,51,32,1.0,43,88,0.489,0.545,0.648,33,57,0.579,0.352,10,31,0.323
1629680,Matisse Thybulle,1610612757,POR,28.0,15,14,1.0,42,88,0.477,0.597,0.455,21,40,0.525,0.545,21,48,0.438
1631197,Jared Rhoden,1610612761,TOR,25.0,14,14,1.0,42,87,0.483,0.552,0.552,30,48,0.625,0.448,12,39,0.308
1642403,Isaac Jones,1610612758,SAC,24.0,40,29,1.0,54,83,0.651,0.669,0.904,51,75,0.68,0.096,3,8,0.375
1641775,Jordan Walsh,1610612738,BOS,21.0,52,41,1.0,30,83,0.361,0.452,0.337,15,28,0.536,0.663,15,55,0.273
1642285,Cam Spencer,1610612763,MEM,25.0,25,19,1.0,34,82,0.415,0.53,0.354,15,29,0.517,0.646,19,53,0.358
1642278,Tyler Kolek,1610612752,NYK,24.0,41,32,1.0,27,82,0.329,0.415,0.427,13,35,0.371,0.573,14,47,0.298
1629057,Robert Williams III,1610612757,POR,27.0,20,18,1.0,50,78,0.641,0.647,0.962,49,75,0.653,0.038,1,3,0.333
1631098,Johnny Davis,1610612764,WAS,23.0,34,30,1.0,32,78,0.41,0.455,0.628,25,49,0.51,0.372,7,29,0.241
1631311,Lester Quinones,1610612740,NOP,24.0,13,13,1.0,31,78,0.397,0.481,0.436,18,34,0.529,0.564,13,44,0.295
1641998,Trey Jemison III,1610612747,LAL,25.0,38,31,1.0,41,74,0.554,0.554,1.0,41,74,0.554,0.0,0,0,
1641798,Jaylen Martin,1610612764,WAS,21.0,16,14,1.0,31,74,0.419,0.466,0.689,24,51,0.471,0.311,7,23,0.304
1627814,Damion Lee,1610612756,PHX,32.0,25,23,1.0,27,74,0.365,0.426,0.5,18,37,0.486,0.5,9,37,0.243
1629669,Jaylen Nowell,1610612740,NOP,25.0,8,7,1.0,26,73,0.356,0.411,0.63,18,46,0.391,0.37,8,27,0.296
1641738,Kobe Brown,1610612746,LAC,25.0,40,27,1.0,33,72,0.458,0.5,0.639,27,46,0.587,0.361,6,26,0.231
1629162,Jordan McLaughlin,1610612759,SAS,29.0,46,28,1.0,31,72,0.431,0.563,0.361,12,26,0.462,0.639,19,46,0.413
1630579,Jericho Sims,1610612749,MIL,26.0,53,32,1.0,45,71,0.634,0.634,1.0,45,71,0.634,0.0,0,0,
202684,Tristan Thompson,1610612739,CLE,34.0,40,30,1.0,31,71,0.437,0.437,0.958,31,68,0.456,0.042,0,3,0.0
1631131,Oscar Tshiebwe,1610612762,UTA,25.0,14,12,1.0,42,70,0.6,0.6,1.0,42,70,0.6,0.0,0,0,
202693,Markieff Morris,1610612747,LAL,35.0,15,14,1.0,21,70,0.3,0.364,0.486,12,34,0.353,0.514,9,36,0.25
1630542,Marcus Bagley,1610612755,PHI,23.0,10,10,1.0,27,69,0.391,0.428,0.536,22,37,0.595,0.464,5,32,0.156
1628365,Markelle Fultz,1610612758,SAC,27.0,21,19,1.0,28,67,0.418,0.448,0.881,24,59,0.407,0.119,4,8,0.5
1642355,Bronny James,1610612747,LAL,20.0,27,20,1.0,21,67,0.313,0.381,0.522,12,35,0.343,0.478,9,32,0.281
1631132,Christian Koloko,1610612747,LAL,24.0,37,25,1.0,40,66,0.606,0.606,0.939,40,62,0.645,0.061,0,4,0.0
1630699,MarJon Beauchamp,1610612752,NYK,24.0,35,29,1.0,27,65,0.415,0.492,0.554,17,36,0.472,0.446,10,29,0.345
203458,Alex Len,1610612747,LAL,31.0,46,29,1.0,32,63,0.508,0.524,0.857,30,54,0.556,0.143,2,9,0.222
1630205,Lamar Stevens,1610612763,MEM,27.0,17,14,1.0,29,63,0.46,0.524,0.571,21,36,0.583,0.429,8,27,0.296
1631306,Cole Swider,1610612761,TOR,26.0,10,10,1.0,22,63,0.349,0.468,0.254,7,16,0.438,0.746,15,47,0.319
1631466,Nate Williams,1610612745,HOU,26.0,20,14,1.0,27,62,0.435,0.484,0.581,21,36,0.583,0.419,6,26,0.231
203939,Dwight Powell,1610612742,DAL,33.0,55,28,1.0,42,61,0.689,0.705,0.918,40,56,0.714,0.082,2,5,0.4
1630696,Dru Smith,1610612748,MIA,27.0,14,13,1.0,31,61,0.508,0.639,0.508,15,31,0.484,0.492,16,30,0.533
202066,Garrett Temple,1610612761,TOR,39.0,28,18,1.0,18,60,0.3,0.35,0.533,12,32,0.375,0.467,6,28,0.214
1630550,JT Thor,1610612764,WAS,22.0,20,19,1.0,25,59,0.424,0.475,0.644,19,38,0.5,0.356,6,21,0.286
203967,Dario Šarić,1610612743,DEN,31.0,16,14,1.0,21,56,0.375,0.438,0.554,14,31,0.452,0.446,7,25,0.28
1642024,Alex Reese,1610612755,PHI,26.0,15,15,1.0,26,54,0.481,0.62,0.241,11,13,0.846,0.759,15,41,0.366
1629001,De'Anthony Melton,1610612751,BKN,27.0,6,6,1.0,22,54,0.407,0.528,0.352,9,19,0.474,0.648,13,35,0.371
1630214,Xavier Tillman,1610612738,BOS,26.0,33,23,1.0,13,53,0.245,0.292,0.396,8,21,0.381,0.604,5,32,0.156
1629011,Mitchell Robinson,1610612752,NYK,27.0,16,15,1.0,34,52,0.654,0.654,1.0,34,52,0.654,0.0,0,0,
1630623,Tyson Etienne,1610612751,BKN,25.0,7,7,1.0,17,52,0.327,0.452,0.154,4,8,0.5,0.846,13,44,0.295
1641890,Tyler Smith,1610612749,MIL,20.0,23,20,1.0,24,50,0.48,0.61,0.4,11,20,0.55,0.6,13,30,0.433
1629650,Moses Brown,1610612742,DAL,25.0,13,9,1.0,34,49,0.694,0.694,1.0,34,49,0.694,0.0,0,0,
1628981,Bruno Fernando,1610612761,TOR,26.0,17,15,1.0,26,49,0.531,0.531,1.0,26,49,0.531,0.0,0,0,
1641723,Kobe Bufkin,1610612737,ATL,21.0,10,10,1.0,18,47,0.383,0.426,0.596,14,28,0.5,0.404,4,19,0.211
1628396,Tony Bradley,1610612754,IND,27.0,14,9,1.0,29,45,0.644,0.656,0.933,28,42,0.667,0.067,1,3,0.333
1631102,TyTy Washington Jr.,1610612756,PHX,23.0,16,11,1.0,14,45,0.311,0.356,0.533,10,24,0.417,0.467,4,21,0.19
1630165,Killian Hayes,1610612751,BKN,23.0,6,6,1.0,18,43,0.419,0.512,0.512,10,22,0.455,0.488,8,21,0.381
1641809,Drew Peterson,1610612738,BOS,25.0,25,18,1.0,17,41,0.415,0.573,0.195,4,8,0.5,0.805,13,33,0.394
1641725,Trey Alexander,1610612743,DEN,22.0,24,14,1.0,13,41,0.317,0.354,0.585,10,24,0.417,0.415,3,17,0.176
1629643,Chuma Okeke,1610612739,CLE,26.0,9,8,1.0,20,40,0.5,0.638,0.3,9,12,0.75,0.7,11,28,0.393
1629052,Oshae Brissett,1610612755,PHI,26.0,6,6,1.0,19,39,0.487,0.564,0.538,13,21,0.619,0.462,6,18,0.333
1641734,Emoni Bates,1610612739,CLE,21.0,10,10,1.0,13,38,0.342,0.487,0.211,2,8,0.25,0.789,11,30,0.367
1626196,Josh Richardson,1610612748,MIA,31.0,8,8,1.0,11,38,0.289,0.368,0.421,5,16,0.313,0.579,6,22,0.273
1642402,Enrique Freeman,1610612754,IND,24.0,22,16,1.0,16,37,0.432,0.446,0.73,15,27,0.556,0.27,1,10,0.1
1628995,Kevin Knox II,1610612744,GSW,25.0,14,10,1.0,18,36,0.5,0.556,0.583,14,21,0.667,0.417,4,15,0.267
1631116,Patrick Baldwin Jr.,1610612746,LAC,22.0,24,17,1.0,19,35,0.543,0.729,0.343,6,12,0.5,0.657,13,23,0.565
1641989,Elijah Harkless,1610612762,UTA,25.0,10,8,1.0,11,35,0.314,0.414,0.286,4,10,0.4,0.714,7,25,0.28
1631120,JD Davison,1610612738,BOS,22.0,16,13,1.0,12,34,0.353,0.412,0.471,8,16,0.5,0.529,4,18,0.222
1642461,Spencer Jones,1610612743,DEN,23.0,20,14,1.0,11,34,0.324,0.338,0.5,10,17,0.588,0.5,1,17,0.059
1642484,RayJ Dennis,1610612754,IND,24.0,11,7,1.0,11,33,0.333,0.424,0.364,5,12,0.417,0.636,6,21,0.286
1631250,Pete Nance,1610612749,MIL,25.0,13,8,1.0,14,32,0.438,0.578,0.25,5,8,0.625,0.75,9,24,0.375
1641772,Nae'Qwan Tomlin,1610612739,CLE,24.0,5,5,1.0,13,32,0.406,0.438,0.688,11,22,0.5,0.313,2,10,0.2
1630574,Ariel Hukporti,1610612752,NYK,23.0,25,14,1.0,21,31,0.677,0.677,1.0,21,31,0.677,0.0,0,0,
1630528,Josh Christopher,1610612748,MIA,23.0,14,10,1.0,11,31,0.355,0.387,0.645,9,20,0.45,0.355,2,11,0.182
1642359,Pacôme Dadiet,1610612752,NYK,19.0,18,13,1.0,10,31,0.323,0.419,0.387,4,12,0.333,0.613,6,19,0.316
1630346,Matt Ryan,1610612752,NYK,28.0,19,14,1.0,10,31,0.323,0.419,0.387,4,12,0.333,0.613,6,19,0.316
1631321,Sidy Cissoko,1610612757,POR,21.0,22,13,1.0,13,30,0.433,0.483,0.567,10,17,0.588,0.433,3,13,0.231
1642505,Alex Ducas,1610612760,OKC,24.0,21,15,1.0,12,30,0.4,0.567,0.3,2,9,0.222,0.7,10,21,0.476
1642530,Yuki Kawamura,1610612763,MEM,24.0,22,13,1.0,11,30,0.367,0.483,0.233,4,7,0.571,0.767,7,23,0.304
1631301,Jaylen Sims,1610612766,CHA,26.0,6,6,1.0,12,28,0.429,0.536,0.464,6,13,0.462,0.536,6,15,0.4
1630585,Marcus Garrett,1610612766,CHA,26.0,4,4,1.0,11,27,0.407,0.463,0.704,8,19,0.421,0.296,3,8,0.375
1641753,Chris Livingston,1610612749,MIL,21.0,21,12,1.0,9,27,0.333,0.333,0.704,9,19,0.474,0.296,0,8,0.0
1642352,Keshad Johnson,1610612748,MIA,23.0,16,6,1.0,18,26,0.692,0.75,0.731,15,19,0.789,0.269,3,7,0.429
1630537,Chris Duarte,1610612741,CHI,27.0,17,14,1.0,12,26,0.462,0.577,0.423,6,11,0.545,0.577,6,15,0.4
1628427,Vlatko Čančar,1610612743,DEN,28.0,13,8,1.0,10,26,0.385,0.462,0.423,6,11,0.545,0.577,4,15,0.267
1630649,Stanley Umude,1610612749,MIL,26.0,22,14,1.0,5,26,0.192,0.25,0.423,2,11,0.182,0.577,3,15,0.2
1631342,Daeqwon Plowden,1610612737,ATL,26.0,6,5,1.0,16,25,0.64,0.82,0.32,7,8,0.875,0.68,9,17,0.529
1641790,PJ Hall,1610612743,DEN,23.0,19,13,1.0,14,24,0.583,0.625,0.667,12,16,0.75,0.333,2,8,0.25
1642353,Cam Christie,1610612746,LAC,19.0,13,9,1.0,7,24,0.292,0.333,0.458,5,11,0.455,0.542,2,13,0.154
1630543,Isaiah Jackson,1610612754,IND,23.0,5,5,1.0,14,23,0.609,0.609,1.0,14,23,0.609,0.0,0,0,
1641789,Jazian Gortman,1610612742,DAL,22.0,16,10,1.0,9,23,0.391,0.478,0.522,5,12,0.417,0.478,4,11,0.364
204060,Joe Ingles,1610612750,MIN,37.0,19,10,1.0,6,23,0.261,0.326,0.348,3,8,0.375,0.652,3,15,0.2
1630283,Kylor Kelley,1610612740,NOP,27.0,11,7,1.0,14,22,0.636,0.636,1.0,14,22,0.636,0.0,0,0,
1631210,Jacob Toppin,1610612737,ATL,25.0,17,8,1.0,9,22,0.409,0.523,0.545,4,12,0.333,0.455,5,10,0.5
203109,Jae Crowder,1610612758,SAC,34.0,9,6,1.0,7,22,0.318,0.409,0.318,3,7,0.429,0.682,4,15,0.267
1631303,Justin Minaya,1610612757,POR,26.0,19,9,1.0,8,21,0.381,0.429,0.524,6,11,0.545,0.476,2,10,0.2
1630762,Phillip Wheeler,1610612755,PHI,23.0,5,5,1.0,3,21,0.143,0.143,0.524,3,11,0.273,0.476,0,10,0.0
1631247,Luke Travers,1610612739,CLE,23.0,12,6,1.0,5,20,0.25,0.25,0.55,5,11,0.455,0.45,0,9,0.0
1642422,Armel Traoré,1610612747,LAL,22.0,9,8,1.0,6,19,0.316,0.316,0.632,6,12,0.5,0.368,0,7,0.0
1630222,Mason Jones,1610612758,SAC,26.0,10,7,1.0,9,18,0.5,0.528,0.556,8,10,0.8,0.444,1,8,0.125
1641707,Taylor Hendricks,1610612762,UTA,21.0,3,3,1.0,4,18,0.222,0.306,0.333,1,6,0.167,0.667,3,12,0.25
1642050,Jackson Rowe,1610612744,GSW,28.0,6,6,1.0,8,17,0.471,0.559,0.412,5,7,0.714,0.588,3,10,0.3
1629098,Jack McVeigh,1610612745,HOU,28.0,9,6,1.0,5,17,0.294,0.412,0.235,1,4,0.25,0.765,4,13,0.308
1630604,E.J. Liddell,1610612741,CHI,24.0,12,6,1.0,8,15,0.533,0.633,0.333,5,5,1.0,0.667,3,10,0.3
1631159,Leonard Miller,1610612750,MIN,21.0,13,8,1.0,6,15,0.4,0.4,0.667,6,10,0.6,0.333,0,5,0.0
1630561,David Duke Jr.,1610612759,SAS,25.0,6,5,1.0,6,14,0.429,0.536,0.571,3,8,0.375,0.429,3,6,0.5
1631121,Bryce McGowens,1610612757,POR,22.0,13,8,1.0,4,14,0.286,0.286,0.714,4,10,0.4,0.286,0,4,0.0
1642368,N'Faly Dante,1610612745,HOU,23.0,4,4,1.0,10,13,0.769,0.769,1.0,10,13,0.769,0.0,0,0,
1630201,Malachi Flynn,1610612766,CHA,27.0,4,3,1.0,5,13,0.385,0.423,0.692,4,9,0.444,0.308,1,4,0.25
1631123,Jamaree Bouyea,1610612749,MIL,25.0,5,3,1.0,6,12,0.5,0.542,0.583,5,7,0.714,0.417,1,5,0.2
1642384,Isaiah Crawford,1610612758,SAC,23.0,15,8,1.0,5,11,0.455,0.5,0.545,4,6,0.667,0.455,1,5,0.2
1642280,Trentyn Flowers,1610612746,LAC,20.0,6,3,1.0,4,11,0.364,0.364,0.818,4,9,0.444,0.182,0,2,0.0
201949,James Johnson,1610612754,IND,38.0,12,7,1.0,4,11,0.364,0.364,0.727,4,8,0.5,0.273,0,3,0.0
1641752,Bobi Klintman,1610612765,DET,22.0,8,2,1.0,6,10,0.6,0.7,0.5,4,5,0.8,0.5,2,5,0.4
1642450,Daniss Jenkins,1610612765,DET,23.0,7,5,1.0,3,10,0.3,0.35,0.3,2,3,0.667,0.7,1,7,0.143
1631386,Tazé Moore,1610612757,POR,26.0,2,2,1.0,2,10,0.2,0.25,0.6,1,6,0.167,0.4,1,4,0.25
1642449,Tolu Smith,1610612765,DET,24.0,1,1,1.0,6,9,0.667,0.667,1.0,6,9,0.667,0.0,0,0,
1641817,Anton Watson,1610612752,NYK,24.0,9,6,1.0,4,9,0.444,0.444,0.889,4,8,0.5,0.111,0,1,0.0
1641936,Miles Norris,1610612738,BOS,25.0,3,2,1.0,2,9,0.222,0.333,0.222,0,2,0.0,0.778,2,7,0.286
1641801,Emanuel Miller,1610612741,CHI,24.0,6,4,1.0,4,8,0.5,0.5,0.875,4,7,0.571,0.125,0,1,0.0
1641857,Liam Robbins,1610612749,MIL,25.0,13,6,1.0,2,8,0.25,0.25,0.75,2,6,0.333,0.25,0,2,0.0
1631199,Ron Harper Jr.,1610612765,DET,25.0,1,1,1.0,1,8,0.125,0.125,0.25,1,2,0.5,0.75,0,6,0.0
1641803,Tristen Newton,1610612750,MIN,24.0,8,6,1.0,1,8,0.125,0.125,0.625,1,5,0.2,0.375,0,3,0.0
1641766,Adama Sanogo,1610612741,CHI,23.0,4,3,1.0,4,7,0.571,0.571,1.0,4,7,0.571,0.0,0,0,
200782,P.J. Tucker,1610612752,NYK,40.0,3,2,1.0,3,7,0.429,0.643,0.143,0,1,0.0,0.857,3,6,0.5
1641755,Kevin McCullar Jr.,1610612752,NYK,24.0,4,3,1.0,2,7,0.286,0.286,0.857,2,6,0.333,0.143,0,1,0.0
1641779,Jalen Bridges,1610612756,PHX,24.0,8,6,1.0,2,7,0.286,0.429,0.0,0,0,,1.0,2,7,0.286
1630600,Isaiah Mobley,1610612755,PHI,25.0,1,1,1.0,2,7,0.286,0.357,0.571,1,4,0.25,0.429,1,3,0.333
1642385,Cui Yongxi,1610612751,BKN,22.0,5,2,1.0,1,7,0.143,0.143,0.571,1,4,0.25,0.429,0,3,0.0
1630618,D.J. Carton,1610612761,TOR,24.0,4,3,1.0,1,7,0.143,0.143,0.571,1,4,0.25,0.429,0,3,0.0
1642443,Jahmir Young,1610612741,CHI,24.0,6,4,1.0,4,5,0.8,0.9,0.6,3,3,1.0,0.4,1,2,0.5
1642279,Ulrich Chomche,1610612761,TOR,19.0,7,4,1.0,2,5,0.4,0.4,1.0,2,5,0.4,0.0,0,0,
1642439,Quincy Olivari,1610612747,LAL,24.0,2,2,1.0,1,5,0.2,0.3,0.0,0,0,,1.0,1,5,0.2
1631127,Harrison Ingram,1610612759,SAS,22.0,5,4,1.0,2,4,0.5,0.5,0.75,2,3,0.667,0.25,0,1,0.0
1630164,James Wiseman,1610612754,IND,24.0,1,1,1.0,2,4,0.5,0.5,0.75,2,3,0.667,0.25,0,1,0.0
1627746,Skal Labissiere,1610612758,SAC,29.0,4,2,1.0,2,4,0.5,0.625,0.75,1,3,0.333,0.25,1,1,1.0
1630296,Braxton Key,1610612744,GSW,28.0,3,1,1.0,0,4,0.0,0.0,0.75,0,3,0.0,0.25,0,1,0.0
1628408,PJ Dozier,1610612750,MIN,28.0,9,3,1.0,2,3,0.667,1.0,0.0,0,0,,1.0,2,3,0.667
1641879,Yuri Collins,1610612744,GSW,24.0,2,1,1.0,1,3,0.333,0.333,1.0,1,3,0.333,0.0,0,0,
1631214,Alondes Williams,1610612765,DET,25.0,1,1,1.0,2,2,1.0,1.25,0.5,1,1,1.0,0.5,1,1,1.0
1642502,Malevy Leons,1610612760,OKC,25.0,6,2,1.0,0,2,0.0,0.0,0.5,0,1,0.0,0.5,0,1,0.0
1630644,Mac McClung,1610612753,ORL,26.0,2,1,1.0,0,2,0.0,0.0,0.5,0,1,0.0,0.5,0,1,0.0
1629056,Terence Davis,1610612758,SAC,28.0,1,1,1.0,0,2,0.0,0.0,0.5,0,1,0.0,0.5,0,1,0.0
1641815,Isaiah Stevens,1610612748,MIA,24.0,3,2,1.0,0,2,0.0,0.0,0.5,0,1,0.0,0.5,0,1,0.0
1642434,Riley Minix,1610612759,SAS,24.0,1,1,1.0,0,1,0.0,0.0,0.0,0,0,,1.0,0,1,0.0
1630678,Terry Taylor,1610612758,SAC,25.0,3,1,1.0,0,1,0.0,0.0,1.0,0,1,0.0,0.0,0,0,
1642389,Zyon Pullin,1610612763,MEM,24.0,3,1,1.0,0,1,0.0,0.0,1.0,0,1,0.0,0.0,0,0,
1630227,Daishen Nix,1610612750,MIN,23.0,3,1,1.0,0,1,0.0,0.0,0.0,0,0,,1.0,0,1,0.0
